{
    "name": "Makeshift Level 1",
    "author": "@NachoYacopu",
    "creationDate": "14-10-2017",
    "tileset": "assets/images/level2.png",
    "tileProperties": [
        "empty",
        "solid",
        "slippery",
        "slope",
        "bouncy"
    ],
    "layoutStyle": "columns",
    "columns": [
        [0, 0, 0, 0, 0, 0, 0, 0, 0, 0, 1],
        [0, 0, 0, 0, 0, 0, 0, 0, 0, 1, 1],
        [0, 2, 1, 0, 0, 0, 1, 1, 1, 1, 2],
        [0, 2, 1, 0, 0, 1, 1, 1, 1, 1, 2],
        [0, 2, 1, 0, 0, 3, 1, 1, 1, 1, 2],
        [0, 2, 1, 0, 0, 0, 3, 1, 1, 1, 2],
        [0, 2, 1, 0, 0, 0, 0, 3, 1, 1, 2],
        [0, 2, 1, 0, 0, 0, 0, 0, 3, 1, 2],
        [0, 2, 1, 0, 0, 0, 0, 0, 0, 3, 2],
        [0, 2, 1, 0, 0, 0, 0, 0, 0, 0, 2],
        [0, 2, 1, 0, 0, 0, 0, 0, 0, 0, 1],
        [0, 0, 0, 0, 0, 0, 0, 0, 0, 0, 2],
        [0, 0, 0, 0, 0, 0, 4, 0, 0, 1, 1],
        [2, 1, 0, 0, 0, 0, 0, 0, 0, 1, 1],
        [2, 1, 0, 0, 0, 0, 2, 1, 1, 1, 1],
        [2, 1, 2, 0, 0, 0, 2, 1, 1, 1, 1],
        [2, 1, 4, 4, 4, 0, 4, 4, 2, 1, 1],
        [2, 1, 2, 1, 0, 0, 0, 2, 1, 1, 1],
        [2, 1, 2, 1, 0, 0, 0, 1, 2, 1, 1],
        [2, 1, 2, 1, 1, 0, 0, 1, 1, 2, 1],
        [2, 1, 2, 1, 0, 0, 0, 3, 1, 2, 1],
        [2, 1, 2, 1, 0, 0, 0, 0, 3, 1, 2],
        [2, 1, 2, 1, 0, 0, 0, 0, 0, 3, 1],
        [2, 1, 2, 1, 0, 0, 0, 0, 0, 0, 2],
        [2, 1, 2, 0, 0, 0, 0, 0, 0, 4, 1],
        [2, 1, 0, 4, 0, 0, 2, 1, 0, 0, 4],
        [0, 4, 4, 0, 0, 0, 0, 0, 0, 0, 1]
    ],
    "level": [
        0, 0, 0, 0, 0, 0, 0, 0, 0, 0, 0, 0,
        1, 2, 3, 4, 5, 6, 7, 8, 9, 10,
        11, 11, 11, 11, 11, 11, 11, 11,
        12, 12, 12, 12, 12, 12, 12, 12, 12, 12, 12, 12, 1,
        13, 13, 13, 13, 13, 13, 13, 13,
        14, 14, 14, 14, 14, 14, 14, 14, 15, 16,
        17, 17, 17, 17, 17, 17, 17, 17,
        18, 18, 18, 18, 18, 18, 18, 18,
        19, 20, 21, 22, 23,
        10, 10, 10, 10, 10, 10, 10, 10,
        10, 10, 10, 10, 10, 10, 10, 10,
        24, 24, 24, 24, 24, 24, 24, 24,
        25, 25, 25, 25, 25, 25, 25, 25,
        25, 25, 25, 25, 25, 25, 25, 25,
        25, 25, 25, 25, 25, 25, 25, 25,
        26, 26, 26, 26, 26, 26, 26, 26,
        26, 26, 26, 26, 26, 26, 26, 26,
        26, 26, 26, 26, 26, 26, 26, 26
    ],
    "goal": 144,
    "authorGhost": [
        5, 39, 49, 58, 67, 87, 185, 194, 233, 267, 277, 289, 310, 346, 392, 425, 492, 500, 506, 514, 520, 577
    ]
}