{
    "name": "Rock Castle",
    "author": "@NachoYacopu",
    "creationDate": "17-10-2017",
    "tileset": "assets/rock_castle.png",
    "tileProperties": [
        "empty",
        "empty",
        "boostfwd",
        "boostfwd",
        "empty",
        "empty",
        "empty",
        "empty",
        "empty",
        "empty",
        "solid",
        "solid",
        "solid",
        "solid",
        "solid",
        "solid",
        "solid",
        "solid",
        "solid",
        "solid"
    ],
    "layoutStyle": "columns",
    "columns": [
        [14, 0, 0, 0, 0, 0, 0, 0, 0, 0, 10],
        [15, 1, 0, 0, 0, 0, 0, 0, 0, 0, 11],
        [16, 0, 0, 0, 0, 0, 0, 0, 0, 0, 12],
        [17, 1, 0, 0, 0, 0, 0, 0, 0, 0, 13],
        [16, 2, 4, 6, 8, 2, 4, 6, 8, 2, 12],
        [17, 3, 5, 7, 9, 3, 5, 7, 9, 3, 13],
        [14, 0, 0, 0, 0, 0, 0, 0, 0, 10, 18],
        [15, 0, 0, 0, 0, 0, 0, 0, 0, 11, 19],
        [16, 0, 0, 0, 0, 0, 0, 0, 0, 12, 18],
        [17, 1, 0, 0, 0, 0, 0, 0, 0, 13, 19],
        [14, 0, 0, 0, 0, 10, 18, 18, 18, 18, 18],
        [15, 0, 0, 0, 0, 11, 19, 19, 19, 19, 19],
        [16, 0, 0, 0, 0, 12, 18, 18, 18, 18, 18],
        [17, 1, 0, 0, 0, 13, 19, 19, 19, 19, 19]
    ],
    "level": [
        0, 1, 4, 5, 0, 1, 2, 3, 0, 1, 4, 5, 0, 1, 2, 3,
        6, 7, 8, 9, 0, 1, 2, 3, 10, 11, 12, 13, 10, 11, 12, 13,
        6, 7, 8, 9, 0, 1, 2, 3, 0, 1, 4, 5, 0, 1, 2, 3,
        6, 7, 8, 9, 0, 1, 2, 3, 10, 11, 12, 13, 10, 11, 12, 13,
        6, 7, 8, 9, 0, 1, 2, 3, 0, 1, 4, 5, 0, 1, 2, 3,
        6, 7, 8, 9, 0, 1, 2, 3, 0, 1, 4, 5, 0, 1, 2, 3,
        6, 7, 8, 9, 0, 1, 2, 3, 10, 11, 12, 13, 10, 11, 12, 13,
        6, 7, 8, 9, 0, 1, 2, 3, 0, 1, 4, 5, 0, 1, 2, 3,
        6, 7, 8, 9, 0, 1, 2, 3, 0, 1, 4, 5, 0, 1, 2, 3,
        6, 7, 8, 9, 0, 1, 2, 3, 0, 1, 4, 5, 0, 1, 2, 3
    ],
    "goal": 144
}